1111111111111
1C01000000011
1100C11111P11
110011E000001
1111111111111