11111111
10E01011
1C000P11
11111111