11111111111
11PCE11111
11111111111
11111111110
