1111111111111
1110000CP0111
1100011110011
110011E000001
1111111111111