111111111
1P1000101
100001C11
100001E01
100100C01
111111111