11111111111
11PCE011111
11111111111


.


11111111111